프론트엔드 8일차 목차

0. CSS 글자 색상
1. CSS 박스 모델
2. CSS 마진과 패딩
3. CSS 디스플레이

------------------------------------------------------------

글자 색상(color) 스타일
	글자(text)의 색상을 변경하기 위한 스타일

글자 스타일 기본 속성
	color : color | initail | inherit

	color		컬러를 직접 설정
			색상 이름 표현			gray, black, white...
			16진수 표현			#ff00ff
			16진수 표현(알파추가)		#ff00ff0f
			RGB 표현				rgb(200,0,0)
			RGBA 표현				rgba(200,200,0,0.5)

	initial	기본값으로 설정

	inherit	부모 요소의 속성값을 상속

박스(box) 모델 스타일
	모든 HTML 요소는 박스(box) 모양으로 구성된 박스 모델(box)을 기본으로 한다.
	박스 모델은 HTML 요소를 테두리(border), 패딩(padding), 마진(margin) 등을 갖는다.

박스 모델 용어
	content(내용)	텍스트나 이미지 등 박스 내의 실제 내용
	border(테두리)	박스의 테두리(내용과 패딩이 안에 포함된다.)
	padding(패딩)	content와 border 사이의 간격(안쪽 여백)
	margin(마진)	border 밖의 여백으로, 주로 이웃 요소와의 간격(여백)으로 사용

박스 모델 기본 속성
	width			박스의 넓이(defalut: display 속성에 의해 결정)
	height		박스의 높이(default: 일반적으로 콘텐츠의 높이)
	background		박스의 배경 색상 또는 이미지(default: X)
	border		박스의 테두리 색상, 굵기, 선 스타일 등(default: X)
	
	padding		테두리 안쪽 여백(default: 0)
	margin		테두리 바깥 여백(default: 0)

border 속성
   border-style      		다양한 모양으로 설정.
   border-width      		너비를 설정.
   border-color      		색상을 설정.
   border-top      		top 부분 속성을 한 번에 설정.
   border-top-style   	top 부분의 스타일을 설정.
   border-top-width   	top 부분의 너비를 설정.
   border-top-color   	top 부분의 색상을 설정.
   border-right      		right 부분 속성을 한 번에 설정.
   border-right-style  	right 부분의 스타일을 설정.
   border-right-width   	right 부분의 너비를 설정.
   border-right-color   	right 부분의 색상을 설정.
   border-bottom      	bottom 부분 속성을 한 번에 설정.
   border-bottom-style   	bottom 부분의 스타일을 설정.
   border-bottom-width   	bottom 부분의 너비를 설정.
   border-bottom-color  	bottom 부분의 색상을 설정.
   border-left      		left 부분 속성을 한 번에 설정.
   border-left-style   	left 부분의 스타일을 설정.
   border-left-width   	left 부분의 너비를 설정.
   border-left-color   	left 부분의 색상을 설정.

   border         		모든 border 속성을 이용한 스타일을 한 줄에 설정 가능.

border style
	none			테두리 없음
	hidden		존재하기는 하지만 표현되지는 않음
	dotted		점선
	dashed		약간 긴 점선
	solid			실선
	그외			double, groove, ridge, inset, outset

margin(마진) 스타일
	margin	테두리 바깥 여백(default: 0)
	
padding(패딩) 스탸일
	padding	테두리 안쪽 여백(default: 0)

대표적인 박스 태그의 마진 특징
	<div>		기본적으로 모든 방향에 margin 값을 가질 수 있다.
	<span>	기본적으로 위(margin-top)/아래(margin-bottom) 값을 가질 수 없다.

collapsing(마진 겹칩/상쇄 현상)
	블록의 top/bottom 여백이 겹칠 때 가장 큰 여백으로 결합되는 현상
	즉, 두 개 이상 블록 요소의 상하 마진이 겹칠 때 가장 큰 값으로 결합하는 렌더링 현상